//MAP CONVERTED BY dmm2tgm.py THIS HEADER COMMENT PREVENTS RECONVERSION, DO NOT REMOVE
"bA" = (
/obj/structure/chair/comfy/shuttle{
	dir = 8;
	name = "tactical chair"
	},
/obj/effect/turf_decal/siding/blue{
	dir = 6
	},
/turf/open/floor/carpet/black,
/area/ship/bridge)
"bW" = (
/obj/structure/window/reinforced/fulltile/shuttle,
/obj/structure/cable/yellow{
	icon_state = "2-5"
	},
/obj/structure/grille,
/obj/machinery/door/poddoor/shutters{
	id = "malp_window"
	},
/turf/open/floor/plating,
/area/ship/bridge)
"cg" = (
/obj/structure/chair/comfy/shuttle{
	dir = 4;
	name = "tactical chair"
	},
/obj/effect/turf_decal/siding/blue{
	dir = 9
	},
/turf/open/floor/carpet/black,
/area/ship/bridge)
"cj" = (
/obj/effect/turf_decal/siding/thinplating/light{
	dir = 4
	},
/turf/open/floor/plasteel/patterned/brushed,
/area/ship/bridge)
"df" = (
/obj/structure/window/reinforced/fulltile/shuttle,
/obj/structure/cable/yellow{
	icon_state = "1-2"
	},
/obj/structure/grille,
/obj/machinery/door/poddoor/shutters{
	id = "malp_window"
	},
/turf/open/floor/plating,
/area/ship/bridge)
"dx" = (
/obj/structure/cable/yellow{
	icon_state = "4-8"
	},
/obj/effect/turf_decal/siding/thinplating/light{
	dir = 8
	},
/turf/open/floor/plasteel/patterned/brushed,
/area/ship/bridge)
"dE" = (
/obj/structure/cable/yellow{
	icon_state = "4-8"
	},
/obj/structure/railing{
	dir = 8
	},
/obj/effect/turf_decal/siding/thinplating/light{
	dir = 4
	},
/obj/effect/turf_decal/siding/thinplating/light{
	dir = 8
	},
/turf/open/floor/plasteel/patterned/brushed,
/area/ship/bridge)
"ej" = (
/obj/machinery/light/floor,
/obj/effect/turf_decal/siding/thinplating/light{
	dir = 9
	},
/obj/structure/barricade/sandbags,
/turf/open/floor/plasteel/patterned/brushed,
/area/ship/bridge)
"eL" = (
/obj/structure/cable/yellow{
	icon_state = "4-8"
	},
/obj/effect/turf_decal/siding/thinplating/light{
	dir = 4
	},
/turf/open/floor/plasteel/patterned/brushed,
/area/ship/bridge)
"fA" = (
/obj/structure/cable/yellow{
	icon_state = "4-8"
	},
/obj/machinery/airalarm/directional/south,
/obj/effect/turf_decal/siding/red{
	dir = 10
	},
/turf/open/floor/plasteel/patterned/brushed,
/area/ship/bridge)
"hC" = (
/obj/structure/chair/comfy/shuttle{
	dir = 4;
	name = "tactical chair"
	},
/obj/effect/turf_decal/siding/blue{
	dir = 10
	},
/turf/open/floor/carpet/black,
/area/ship/bridge)
"jz" = (
/obj/structure/cable/yellow{
	icon_state = "0-2"
	},
/obj/structure/catwalk/over/plated_catwalk/dark,
/obj/machinery/porta_turret/ship/weak{
	dir = 9
	},
/turf/open/floor/plating,
/area/ship/bridge)
"mU" = (
/obj/structure/railing,
/obj/machinery/light/floor,
/obj/effect/turf_decal/siding/thinplating/light{
	dir = 10
	},
/turf/open/floor/plasteel/patterned/brushed,
/area/ship/bridge)
"nP" = (
/obj/structure/cable/yellow{
	icon_state = "0-2"
	},
/obj/structure/catwalk/over/plated_catwalk/dark,
/obj/machinery/porta_turret/ship/weak{
	dir = 4
	},
/turf/open/floor/plating,
/area/ship/bridge)
"on" = (
/obj/structure/cable/yellow{
	icon_state = "1-8"
	},
/obj/machinery/light/floor,
/obj/structure/table/reinforced,
/obj/effect/turf_decal/siding/red{
	dir = 5
	},
/obj/item/radio/intercom/wideband/table{
	dir = 4;
	pixel_x = 6;
	pixel_y = 1
	},
/obj/machinery/button/door{
	pixel_x = -9;
	dir = 8;
	pixel_y = 8;
	id = "malp_door";
	name = "MALP Hander Doors"
	},
/obj/machinery/button/shieldwallgen{
	dir = 8;
	name = "MALP Holofield Switch";
	pixel_x = -10;
	pixel_y = 0;
	id = "malp_holo"
	},
/obj/machinery/light/directional/east,
/turf/open/floor/plasteel/patterned/brushed,
/area/ship/bridge)
"pi" = (
/obj/machinery/suit_storage_unit/security,
/obj/effect/turf_decal/siding/thinplating/light{
	dir = 5
	},
/obj/machinery/turretid{
	pixel_y = 25
	},
/turf/open/floor/plasteel/patterned/brushed,
/area/ship/bridge)
"qG" = (
/obj/structure/railing/corner{
	dir = 8
	},
/obj/effect/turf_decal/siding/thinplating/light{
	dir = 4
	},
/obj/effect/turf_decal/siding/thinplating/light/corner{
	dir = 8
	},
/turf/open/floor/plasteel/patterned/brushed,
/area/ship/bridge)
"qH" = (
/obj/structure/window/reinforced{
	dir = 1
	},
/obj/structure/cable/yellow{
	icon_state = "4-8"
	},
/obj/machinery/light/floor,
/obj/effect/turf_decal/siding/yellow{
	dir = 9
	},
/turf/open/floor/plasteel/tech,
/area/ship/bridge)
"qI" = (
/obj/structure/window/reinforced/tinted/frosted{
	dir = 4
	},
/obj/structure/rack,
/obj/structure/closet/crate/medical,
/obj/machinery/door/window{
	dir = 1;
	name = "Medical Supplies"
	},
/obj/effect/turf_decal/siding/yellow/end,
/turf/open/floor/plasteel/tech,
/area/ship/bridge)
"qP" = (
/turf/open/floor/plasteel/patterned/brushed,
/area/ship/bridge)
"rS" = (
/obj/machinery/computer/helm{
	dir = 8
	},
/obj/effect/turf_decal/siding/red{
	dir = 4
	},
/turf/open/floor/plasteel/patterned/brushed,
/area/ship/bridge)
"se" = (
/obj/structure/cable/yellow{
	icon_state = "4-8"
	},
/obj/structure/cable/yellow{
	icon_state = "1-8"
	},
/obj/structure/cable/yellow{
	icon_state = "2-8"
	},
/obj/machinery/door/window/brigdoor/northleft{
	dir = 4
	},
/obj/effect/turf_decal/siding/yellow{
	dir = 4
	},
/obj/effect/turf_decal/siding/yellow/corner{
	dir = 1
	},
/turf/open/floor/plasteel/tech,
/area/ship/bridge)
"sV" = (
/obj/structure/cable/yellow{
	icon_state = "1-2"
	},
/obj/machinery/door/window/brigdoor/southright{
	dir = 4
	},
/obj/effect/turf_decal/siding/yellow{
	dir = 4
	},
/obj/effect/turf_decal/siding/yellow/corner{
	dir = 8
	},
/turf/open/floor/plasteel/tech,
/area/ship/bridge)
"tq" = (
/obj/structure/cable/yellow{
	icon_state = "2-8"
	},
/obj/machinery/light/floor,
/obj/structure/table/reinforced,
/obj/effect/turf_decal/siding/red{
	dir = 6
	},
/obj/item/radio/intercom/table{
	dir = 4;
	pixel_x = 6;
	pixel_y = 4
	},
/obj/machinery/button/door{
	pixel_x = -9;
	dir = 8;
	pixel_y = 8;
	id = "malp_engine";
	name = "MALP Engine"
	},
/obj/machinery/button/door{
	pixel_x = -9;
	dir = 8;
	pixel_y = -3;
	id = "malp_window";
	name = "MALP Windows"
	},
/obj/machinery/light/directional/east,
/turf/open/floor/plasteel/patterned/brushed,
/area/ship/bridge)
"tD" = (
/obj/structure/cable/yellow{
	icon_state = "1-2"
	},
/obj/machinery/atmospherics/pipe/simple/supply/hidden/layer2,
/obj/effect/turf_decal/siding/thinplating/light,
/turf/open/floor/plasteel/patterned/brushed,
/area/ship/bridge)
"ug" = (
/obj/structure/cable/yellow{
	icon_state = "1-2"
	},
/obj/structure/cable/yellow{
	icon_state = "2-4"
	},
/obj/machinery/atmospherics/pipe/simple/supply/hidden/layer2,
/obj/machinery/atmospherics/components/unary/vent_scrubber/on/layer4{
	dir = 1
	},
/turf/open/floor/plasteel/patterned/brushed,
/area/ship/bridge)
"ur" = (
/obj/structure/window/reinforced{
	dir = 1
	},
/obj/machinery/power/smes/engineering,
/obj/structure/cable/yellow{
	icon_state = "0-4"
	},
/obj/structure/catwalk/over/plated_catwalk/dark,
/obj/machinery/light/directional/west,
/turf/open/floor/plating,
/area/ship/bridge)
"uw" = (
/obj/structure/chair/comfy/shuttle{
	dir = 4
	},
/obj/effect/turf_decal/siding/red{
	dir = 8
	},
/turf/open/floor/plasteel/patterned/brushed,
/area/ship/bridge)
"uy" = (
/obj/machinery/power/terminal{
	dir = 8
	},
/obj/structure/cable/yellow{
	icon_state = "0-4"
	},
/obj/structure/cable/yellow{
	icon_state = "4-10"
	},
/obj/structure/catwalk/over/plated_catwalk/dark,
/turf/open/floor/plating,
/area/ship/bridge)
"uQ" = (
/obj/machinery/atmospherics/components/unary/vent_pump/on/layer2{
	dir = 1
	},
/obj/effect/turf_decal/siding/blue,
/obj/machinery/light_switch{
	dir = 1;
	pixel_y = -18
	},
/turf/open/floor/carpet/black,
/area/ship/bridge)
"vL" = (
/obj/machinery/power/smes/shuttle/precharged{
	dir = 4
	},
/obj/structure/window/reinforced{
	dir = 8
	},
/obj/structure/catwalk/over/plated_catwalk/dark,
/obj/structure/cable/yellow{
	icon_state = "0-8"
	},
/obj/machinery/door/poddoor/preopen{
	id = "malp_engine";
	dir = 4
	},
/turf/open/floor/plating,
/area/ship/bridge)
"wy" = (
/obj/structure/sign/number/random,
/turf/closed/wall/mineral/plastitanium/nodiagonal,
/area/ship/bridge)
"xz" = (
/obj/structure/cable/yellow,
/obj/structure/catwalk/over/plated_catwalk/dark,
/obj/machinery/porta_turret/ship/weak{
	dir = 10
	},
/turf/open/floor/plating,
/area/ship/bridge)
"Az" = (
/obj/structure/cable/yellow{
	icon_state = "1-4"
	},
/obj/machinery/atmospherics/pipe/simple/supply/hidden/layer2,
/obj/effect/turf_decal/siding/blue{
	dir = 1
	},
/turf/open/floor/carpet/black,
/area/ship/bridge)
"AA" = (
/turf/closed/wall/mineral/plastitanium/nodiagonal,
/area/ship/bridge)
"BB" = (
/turf/template_noop,
/area/template_noop)
"CN" = (
/obj/machinery/computer/security{
	dir = 8
	},
/obj/effect/turf_decal/siding/red{
	dir = 4
	},
/turf/open/floor/plasteel/patterned/brushed,
/area/ship/bridge)
"DD" = (
/obj/effect/turf_decal/siding/thinplating/light{
	dir = 8
	},
/turf/open/floor/plasteel/patterned/brushed,
/area/ship/bridge)
"Fo" = (
/obj/structure/window/reinforced/fulltile/shuttle,
/obj/structure/cable/yellow{
	icon_state = "1-6"
	},
/obj/structure/grille,
/obj/machinery/door/poddoor/shutters{
	id = "malp_window"
	},
/turf/open/floor/plating,
/area/ship/bridge)
"Gb" = (
/obj/structure/cable/yellow{
	icon_state = "1-8"
	},
/obj/structure/window/reinforced/tinted/frosted{
	dir = 4
	},
/obj/effect/turf_decal/siding/yellow{
	dir = 4
	},
/obj/effect/turf_decal/siding/yellow{
	dir = 8
	},
/turf/open/floor/plasteel/tech,
/area/ship/bridge)
"GK" = (
/obj/structure/cable/yellow,
/obj/structure/catwalk/over/plated_catwalk/dark,
/obj/machinery/porta_turret/ship/weak{
	dir = 4
	},
/turf/open/floor/plating,
/area/ship/bridge)
"Ho" = (
/obj/structure/cable/yellow{
	icon_state = "1-2"
	},
/obj/machinery/atmospherics/components/binary/pump/layer2,
/obj/machinery/atmospherics/components/binary/pump/layer4{
	dir = 1
	},
/obj/effect/turf_decal/siding/thinplating/light{
	dir = 1
	},
/turf/open/floor/plasteel/patterned/brushed,
/area/ship/bridge)
"If" = (
/obj/structure/window/reinforced,
/obj/machinery/light/floor,
/obj/effect/turf_decal/siding/yellow{
	dir = 10
	},
/turf/open/floor/plasteel/tech,
/area/ship/bridge)
"Jq" = (
/obj/docking_port/mobile{
	can_move_docking_ports = 1;
	preferred_direction = 4;
	port_direction = 8;
	dir = 2;
	name = "malp dock"
	},
/obj/machinery/atmospherics/pipe/simple/supply/hidden/layer2,
/obj/machinery/atmospherics/pipe/simple/scrubbers/hidden/layer4,
/obj/structure/cable/yellow{
	icon_state = "1-2"
	},
/obj/structure/cable/yellow{
	icon_state = "2-4"
	},
/obj/structure/cable/yellow{
	icon_state = "2-8"
	},
/obj/machinery/door/firedoor/border_only{
	dir = 2
	},
/obj/machinery/door/firedoor/border_only{
	dir = 1
	},
/obj/structure/catwalk/over/plated_catwalk/dark,
/obj/machinery/door/poddoor/preopen{
	id = "malp_door"
	},
/turf/open/floor/plating,
/area/ship/bridge)
"JJ" = (
/obj/structure/cable/yellow{
	icon_state = "1-8"
	},
/obj/structure/cable/yellow{
	icon_state = "2-8"
	},
/obj/machinery/atmospherics/pipe/simple/supply/hidden/layer2,
/turf/open/floor/plasteel/patterned/brushed,
/area/ship/bridge)
"LM" = (
/obj/machinery/power/terminal{
	dir = 8
	},
/obj/structure/cable/yellow{
	icon_state = "0-4"
	},
/obj/structure/cable/yellow{
	icon_state = "4-9"
	},
/obj/structure/catwalk/over/plated_catwalk/dark,
/obj/structure/closet/secure_closet/security/sec,
/turf/open/floor/plating,
/area/ship/bridge)
"Mz" = (
/obj/structure/cable/yellow{
	icon_state = "0-8"
	},
/obj/machinery/door/firedoor/border_only{
	dir = 2
	},
/obj/machinery/door/firedoor/border_only{
	dir = 1
	},
/obj/structure/catwalk/over/plated_catwalk/dark,
/obj/machinery/door/poddoor/preopen{
	id = "malp_door"
	},
/obj/machinery/power/shieldwallgen/atmos/roundstart{
	dir = 8;
	id = "malp_holo"
	},
/turf/open/floor/plating,
/area/ship/bridge)
"Ns" = (
/obj/machinery/suit_storage_unit/security,
/obj/structure/railing{
	dir = 8
	},
/obj/effect/turf_decal/siding/thinplating/light/end,
/turf/open/floor/plasteel/patterned/brushed,
/area/ship/bridge)
"Ny" = (
/obj/machinery/light/floor,
/obj/effect/turf_decal/siding/thinplating/light{
	dir = 1
	},
/obj/structure/barricade/sandbags,
/turf/open/floor/plasteel/patterned/brushed,
/area/ship/bridge)
"NV" = (
/obj/structure/grille,
/obj/structure/window/reinforced/fulltile/shuttle,
/obj/machinery/door/poddoor/shutters{
	id = "malp_window";
	dir = 4
	},
/turf/open/floor/plating,
/area/ship/bridge)
"Pp" = (
/obj/structure/cable/yellow{
	icon_state = "0-4"
	},
/obj/structure/catwalk/over/plated_catwalk/dark,
/obj/machinery/door/firedoor/border_only{
	dir = 2
	},
/obj/machinery/door/firedoor/border_only{
	dir = 1
	},
/obj/machinery/door/poddoor/preopen{
	id = "malp_door"
	},
/obj/machinery/power/shieldwallgen/atmos/roundstart{
	dir = 4;
	id = "malp_holo"
	},
/obj/machinery/light_switch{
	dir = 4;
	pixel_x = -23
	},
/turf/open/floor/plating,
/area/ship/bridge)
"QL" = (
/obj/machinery/power/shuttle/engine/electric/premium{
	dir = 4
	},
/obj/structure/cable/yellow{
	icon_state = "0-4"
	},
/turf/open/floor/plating,
/area/ship/external)
"RG" = (
/obj/structure/window/reinforced,
/obj/machinery/power/terminal{
	dir = 1
	},
/obj/machinery/power/port_gen/pacman,
/obj/item/stack/sheet/mineral/plasma/ten,
/obj/structure/catwalk/over/plated_catwalk/dark,
/obj/machinery/light/directional/west,
/turf/open/floor/plating,
/area/ship/bridge)
"VY" = (
/obj/structure/cable/yellow{
	icon_state = "2-8"
	},
/obj/structure/window/reinforced/tinted/frosted{
	dir = 4
	},
/obj/effect/turf_decal/siding/yellow{
	dir = 4
	},
/obj/effect/turf_decal/siding/yellow{
	dir = 8
	},
/obj/item/storage/box/emptysandbags,
/turf/open/floor/plasteel/tech,
/area/ship/bridge)
"Wl" = (
/obj/structure/railing,
/obj/structure/railing,
/obj/machinery/light/floor,
/obj/effect/turf_decal/siding/thinplating/light,
/turf/open/floor/plasteel/patterned/brushed,
/area/ship/bridge)
"Wx" = (
/obj/structure/window/reinforced/tinted/frosted{
	dir = 4
	},
/obj/structure/rack,
/obj/structure/closet/crate,
/obj/machinery/door/window{
	dir = 2
	},
/obj/effect/turf_decal/siding/yellow/end{
	dir = 1
	},
/turf/open/floor/plasteel/tech,
/area/ship/bridge)
"Xk" = (
/obj/structure/cable/yellow{
	icon_state = "4-8"
	},
/obj/machinery/power/apc/auto_name/directional/north,
/obj/structure/cable/yellow{
	icon_state = "0-8"
	},
/obj/effect/turf_decal/siding/red{
	dir = 9
	},
/turf/open/floor/plasteel/patterned/brushed,
/area/ship/bridge)
"Xr" = (
/obj/structure/cable/yellow{
	icon_state = "4-8"
	},
/turf/open/floor/plasteel/patterned/brushed,
/area/ship/bridge)
"Zt" = (
/obj/structure/cable/yellow{
	icon_state = "4-8"
	},
/obj/structure/chair/comfy/shuttle{
	dir = 8;
	name = "tactical chair"
	},
/obj/effect/turf_decal/siding/blue{
	dir = 5
	},
/turf/open/floor/carpet/black,
/area/ship/bridge)

(1,1,1) = {"
BB
AA
QL
AA
AA
QL
AA
BB
"}
(2,1,1) = {"
jz
Fo
vL
ur
RG
vL
bW
xz
"}
(3,1,1) = {"
AA
AA
LM
qH
If
uy
AA
AA
"}
(4,1,1) = {"
AA
Wx
VY
se
sV
Gb
qI
AA
"}
(5,1,1) = {"
Pp
ej
DD
dx
mU
cg
hC
AA
"}
(6,1,1) = {"
Jq
Ho
ug
JJ
tD
Az
uQ
wy
"}
(7,1,1) = {"
Mz
Ny
Xr
qP
Wl
Zt
bA
wy
"}
(8,1,1) = {"
AA
pi
eL
cj
qG
dE
Ns
wy
"}
(9,1,1) = {"
AA
AA
Xk
uw
uw
fA
AA
AA
"}
(10,1,1) = {"
nP
df
on
rS
CN
tq
df
GK
"}
(11,1,1) = {"
BB
AA
AA
NV
NV
AA
AA
BB
"}
